.@..@.@..@@.@..........@@.....@.@..@@@@@..@...@@........@@...@...@.....@@.....@@....@@@..............@..............@.@........@
.........@.......@..@.......@.@.@.@@@..@....@.........@.@@......@.@...@....@@..@@.@..@..@@.@.@...@................@@......@.....
........@...@......@@.@....@.......@....@@..@.@.@@........@@.@......@@@..@@....@........@..@....@.....@...........@..@.....@@..@
...........@@......@......@@..@.@...@@..@....@...@.@...@@..@......@@@...@.......@@...@.@.@..@@...@@......@.........@..@........@
....@..@.@....@...@......@..@.@...@..@.............@.......@.@.@..@....@@......@@..@@.........@..@....@.@.@..@.......@.....@@...
@..@@.......@..@....@.@@.............@........@@.@....@.@.@@@..@@........@.@..........@.@..@.@....@.......@......@....@@.@@.@...
.@@..@@.....@..@....@....@....@...@.@........@.....@..@.@.@@@....@....@...............@...@.....@@..@.@.@.@......@...........@..
....@....@...@.....@..@............@....@........@@....@...@..@.......@@.@....@...@@......@.....@....@......@....@...@.@@..@....
@@@....@.@.....@.@....@.........@...@........@..@@@...@....@.@@@.......@......@.@..@....@..@...@...@..@@@.@....@...@..@@@@@@.@..
..@......@....@.@....@.@....@.@....@..........@..@......@.....@......@..@@...@......@...@......@....@@@..@.@..@........@@.......
..@...@@...@.@..@...@...........@......@..@...@....@......................@@..@@..@@......@@...@..@..@..@@....@..@..@@@....@.@..
.@.@..............@@.@...@@..@.@.@.@............@...@.@.....@....@.......@...@..@..@@@..................@.@...@.@@.@@@.@...@@@.@
.....@.@.......@.@.@..@.@@@............@@.@@.@.@........@.......@@.....@@....@......@.@.....@.@@....@......@@@......@..@........
.....@.....@.@@.......@..@......@@...@.....@@@@...@...@.@@@..@.@@@@@.@..........@.@....@..........@...........@.@.........@...@.
..@....@...@.@.@........@...@@@..@@......@..@@..@.........@@.@.@@..@........@.@..@.....@................@.....@.@.@.....@@.@.@@@
....@...@.@........@@@..@..@..@...........@.@..@.@.@.................@.........@..@....@..@@..@............@@...........@@......
.....@..@.@.@.@@.@@@@........@.....@..@..@@..@...@..@.@....@@@......@@@...@.@.@.@...@@..........@..@..@.@@....@.........@...@...
...@.........@@...@@..@...@..@.@@...@.@.@.@@.@...@......@..@@...@.......@.......@....@..........@.@...@..@..@...@...............
..@..........@.@.@.@..@..@@@............@..........@..@@..@@@...@@@....@@.@....@.....@@.@@...................@...@...........@..
.....@..@..@...@.@...@@@..@...@...@....@@@...@@..@@....@@.....@...@@.........@.@..@@@...@.....@.......@.@..@.....@.@..@@.....@.@
............@....@@...@@@.@....@.@@.@...@@@@.........@.@...@...........@@@.@.@...@................@.@...@.@........@@@.@.....@..
.....@..@.......@....@@@@..@..@......@...@........@.......@@.....@..@...@.@...@.....@.@..@.@.............@.@...@.....@..@.......
....@.....@...@.@.....@@@........@..@.....@..@.@....@@.......@...@.....@....@.....@....@.@......@.......@..@@@@........@.....@..
.@.@.............@....@......@....@@@..@@@....@..........@..@..........@........@@..@.@...@......@.....@@....@...@..@....@.@..@@
........@...@..@@...@............@@..@...@@......@.@.@....@..........@....@.....@.@....@..@.....@..@.....@..@@@....@@@..........
...@..@.@.......@.....@..@.@..@........@...@..@...@..@....@..@....@.....@.@@..@.......@@.@@...@@@@.....@@.......@..@@..@@.....@.
....@@@....@..@..@..@...@@........@@@.......@..@...@.......@..@...@@.@@....@....@.@.@@.....@..@.@....@@............@.@....@@...@
@..@@....@@@.........@...@@.@......@@@@..........@.@.@@@..@@.....@...@@@@...............@..@....@.@........@@.....@..@........@.
....@@@@@.@....@.@.@....@.@@@@@...@@........@....@......@...@..@@@@..@..@@....@......@.@....@@...@@..@........@@...@.....@@.....
.....@@...@@.......@.@......@........@................@.@.......@@@.@.........@.........@@....@..@...@@@.......@........@..@....
@........@............@...........@@..@................@...@.@..@@..@...@.......@.....@@....................@.@.........@....@..
@@...@@..@@@.@........@@.@@..........@..@.@@@.....@...@......@@@..@@.......@@.@..@.....@....@@..@@..@......@.@.......@...@@...@@
........@.....@..@@....@.....@@.@.@........@@.@..@...@.......@..@...............@.........@@......@................@....@.......
@..@.@...@.@......@..@........@.@..@@@@.@@@@.@..@@...@...@....@.@.@........@@.........@......@....@.......@...@...@.....@@.@@...
...@@@..@@.........@...@.@..@................@.....@.....@..@...@.@..........@..@@@@.......@......@..@@..@..@...........@......@
.@......@..@...@.@..@...............@@@......@.......@@@....@.@@.@..@.........@..........@.......@.@@.......@...@.....@...@.@..@
@..............@..............@@@@.....@@.........@....@.................@@......@..@.@.@...........@..@...@.@.@.............@..
@.@...@........@...@....@.@@...@@....@@............@....@..@@.@.@......@...@.@..@@@.@..@...........@....@............@.@@..@....
.@@..@.@..........@..@.............@.@...@@...@.@@............@..@...@......@@@@.@....@@....@..@...@.@..@.....@........@..@.....
....@........@....@..@........@........@..@@......@@@.@.....@...@.......@....@....@.....@..@.@.......@..@..@.@....@..@...@..@...
.....@@..@.@.@.......@....@...@@........@.......@.@.....@..........@.@.............@@......@..@...@..@....@.............@.......
...................@....@..@......@.@....@....@@@.....@.@@.@@..@....@..@.......@.@....@.@@@@..@.@......@...@@.....@@@..@@@.@.@..
........@@@......@@.@@...@@@..@.@@.@..@.@.@@.....@....@.@..@@@@.@...@.....@@.........@.@@@@..@.@...@..@.....@@.@@...........@.@.
..@@@......@.............@......@...@@@........@..@..@@......@@...@...@@...@....@......@@@@@.@.....@@...@.@@........@@....@.....
....@..@.@....@@@@.@@@@@@@.@@.@...@.....@@...........@..@....@@@.@@@..@@....@@.........@.@@@........@.@.@.......@....@@@@.......
....@....@@.....@@.....@@@@.@.@..@.........@...............@@.@...............@.@@..@..@....@.@.@....@.........@..@@..@....@....
..@.@..@......@.............@.........@...............@..@....@@@.@..@.@........@@@.@...@.@@.....@...@..@......@..@...@@........
...@.@.@@..@@.@@.@............@@...@..@@..@...@@..@.....@...@......@@....@...@......@...@...........@@@......@......@.....@....@
......@..@....@..@@.@...@..@..@.....@.@.....@....@.@..@.............@.@...............@...@...@@....@@.@@......@.@...........@..
.@@.......@...@....@....@@......@.@@@..@.....@@.....@@@@....@.@.@........@.....@@..........@..@.........@@@...@...@.@...@@.@..@.
..@.@..@...@.@..@@.@...@.....@@..@@......@.@..........@..@......@.@......@...@..@.@@........@...@.@...@.@@.@@....@@.@@...@@...@.
..........@..@...@@....@@...@..@..@@.@...@..@..@.@.@....@@@.@@............@@....@..@@....@....@.........@...........@@@.@.......
........@@@..@........@..@@............................@.@.@....@.........@.......@@......@...@..........@..@......@@@@....@...@
.....@.@.........@.@.@...@....@@......@........@...@.@.@......@@@..@.@@....@......@..@@.....@@......@......@@...@@@@@..@.@@...@@
....................@.@.@@...@.....@..@@..@....@..@..@....@.@.@@@...@..@@...@@.@.@..@.......@.@.@..@.@...........@..@.@....@..@.
@.....@...@@....@@.@....@......@@@........@.....@..@......@..@@....@@.@@@.....@.......@.@.@.......@@.@.@@........@@...@.@.......
@@.@.......@@....@......@@@.@..@......@@@.@.@@.@.....@...@...@..@......@...@.......@.@.@.@.@@..@.............@..........@...@@..
@.@.........@@@@.@.........@...@.........@.....@....@...@....@...@.@.......@@........@.@...@.@....@..@......@.......@.@.........
..@..@..@@...@..@@.@..@..@.@@..@...........@.@..........@...@.@..@..........@...@...@..@@..@.....@.......@......@..@..@@.@@.@.@.
..@...@...@...@.......@..@...@....@....@.@..@.....@...@....@.....@..@.@....@@@@.@...@..@....@.@....@........@..@@@........@...@.
.......@.@@...@....@..@.......................@...........@....@@..@@........@........@..............@..........@.@..@......@..@
.........@.@..@.......@....@.@@@.@....@@..@.@@..@.@@@@..@....@.@.@..@...........@...@..@..........@...@....@.@............@....@
..@@..@......@.@@.@.@.............@..@@...........@@...@...@.@@..@@.@......@..@.@.....@..@.....@@.@..@..........@@..@@...@..@.@@
.@@.....@...........@....@.@..@@.@...@.......@.....@@@.@..@@.@@..@...@....@..@..@@.@..@.@.@.......@...@@.....@......@@......@@@@
....@..@....@.@@............@....@....@.@@..@...@...@..@......@...@@...@..@.........@@@........@..@..@..@@@..@@@@...@.@.@@..@.@@
...@..@.........@@@............@@......@.@.@@.@..@...@.......@.....@...@..@@....@@@..@..@...@......@.@@.@..@..@@........@..@....
.........@...@.@@...@...@@.@.@.@..@@........@....@@.........@.@...@.....@.@.@....@....@....@...@...............@...@...@..@..@..
........@..@.....@...@@......@.@.@@@@.@....@@@.@..@.@.@....@...@..@.....@.......@.@...@@@...@..@................@...@....@...@.@
...@..@.....@.@@.@.@..@.@@..@.....@@.@......@.....@.......@...@@.@.@..@...@.@.....@@......@...@...@.@@.@.@....@...@.......@.@...
...@..@@.@................@.@....@@........@...@@..@..@@.....@@@........@..@........@.........@...@.......@......@.............@
..........@@@....@.....@.@@.......................@@@.@.......@....@.........@.......@....@.@.@..@@....@@@..........@.@.@.....@.
.@@.@.@..@......@......@.@..@.....@@..........@..........@..@@...@...@......@@@@.@...@..............@@...@...@......@...........
..@..@@..................@@.@@....@.......@@..@...@.......@......@.....@.@@.@@......@.@....@..@@..........@......@.@@...........
......@..@.@..........@@@@..........@.@@..@...@@@.....@.....@@.@...@...@@....@.....@....@.@.@..@...@..............@....@....@..@
...@@@....@....@...........@....@.................@...@@...@.@.....@..@........@.@......@.@..@.....@@@...@@@.....@.@@...@.......
@.@@@@@......@..@@....@..@@@@....@.@.@..............@.@........@.....@@...@.@@..@@...@@@......@@.....@......@........@...@.@....
..@........@...........@.........@@....@.@.@.........@.....@@@@..@@.@....@......@..@....@@.@.@..@@...@@....@........@.@@.@@..@..
...............@@...@....@...@..@...@...@........@........@.@..@@..@...@.......@........@@@...@.@@.@..........@....@.....@@.....
.@@@....@.......@.....@..@...@@.....@@.@@@..@...@..@........@.@.........@..@.....@..@.........@.....@@@@.@.@.....@....@.......@.
...@...........@@...........@@....@........@....@...@.......@.............@.....@......@.......@..@...............@@.@..@..@@@..
@.....@.@..@@.....@...@@.@...@...@..@.@....@.......@......@@...@......@.@.@........@...@..................@...@........@@..@....
........@....@@.@@.@...@.@@.@.........@..@......@.............@@@...@@..@.............@.@.@.@...@..@.......@@...@....@.@.....@@@
@@....@.....@@..@.....@...@@@.................@...@...@@.......@...@..@....@...............@..@...@..@.@@......@@.....@...@.....
.........@......@..@......@....@....@.@@...@...........@....@@.......@..@.@@.@....@.@.@.@...@......@@.@..........@@.....@@......
....@....@@...@.@@....@..........@.........@..@@@....@......@@.@...@....@....@.....@@@@......@....@.@....@...@.@@.....@.........
@..........@@...@...............@@@.@..@..@......@..@......@.@@...@...@......@.............@...@@@..@.....@..........@@@........
...@.@....@..@@..@......@@@..@@..@...@.@.@......@..........@...........@@...@@...@...@...........@..........@.@.@.....@..@.@@.@.
@.....@....@...@@.@.@..@..@.@..@@..@...@...........@@..............@@@..@............@..............@..@@..@@@.@....@@...@@@@..@
..@...@..@...@........@..@..@........@.@@.........@@.@.....@.@@.@.........@.....@.....@......@.@.....@@@.@@@@@..@...@..@...@....
.@................@@@....@@@@.....@.@..@@@......@..@.............@.......@.@..@..@...@@.@..@..............@@@@.....@....@.@@.@.@
...@.....@.@......@@..@...@@@..@@@.....@@@.....@....@...@..@...@@..@..@.....@....@@.@..........@...........@@@@...@@@..@@.@.....
@@@@@......@....@..@.......@@@..@@......@..@..@@...@@@...@..@...@.....@.@......@......@....@...............@@@@@..@...@....@....
...@@@.....@..@.@...@@@@...@@......@....@....@.@@.@@.@.@@...@....@@......@...@@@@@..@.......@..@.@@@......@@@.......@@@@.@..@...
@@.@@@.......@....@..@...@..........@....@@......@.......@.@..@.@..@....@......@@.......@..@...@@.....@.....@...@..@.....@.@@@..
....@.@.@..@......@...@......@@..@@.........@..@@....@..@.....@.....@.@.....@@..@@......@.......@....@.....@@...@......@@.....@@
.@.........@.@........@..@..@@.@....@..@@@@....@...@.@.@....@..@@......@...@....@..@........@........@.@@.....@........@...@....
.@....@.@@.@..@...@.@.@.@.@.@.......@..@.....@...@....@...........@.@...@.@.@@.@...@.........@.......@....@.@@...........@......
@..@...@@@@...@...@...@.@....@@.@@....@@@.........@...@.@@.@@@.@....@.@.......@........@...@@@@@...@.@..@@@......@...@..@@@@....
.....@....@.....@@....@..@@.@.....@....@........@.@.@...........@@.....@@@.@......@@..@......@..@...@..@.....@@......@.....@..@@
.....@....@@.@..@@@...@.@..@...@.@.@.@.@......@@......@.@.@@..@@@@.@..@...@@...@..@...@...........@...@..........@@........@@...
..@..@..........@@..@...@.@.....@@...@..@....@.........@.@@....@@........@@..@........@....@...@@.@.@.@.@..@.....@.............@
...@......@.@.@....@.@@.@.....@...@......@....@...@.@....@...@...@.@............@..@..@..@@@.......@.....@@......@..............
......@@..@@@@...@....@...@@@..@.@.@..@@...........@@@.@@@..@.@..@@@.@.@...@.....@..@..@..@@..........@..@.......@@.............
....@......@@....@......@@..@@@.................@...@.....@@@....@@@..@..........@.@.......@....@.....@...@.@@..@@....@.@....@.@
@..@.........@....@@@.........@.@..............@...................@.@...@.@.@.@.....@@....@@........@....@@..@....@..@.@@.@....
@@.@.@..@.@@.....@......@..@........@.@..@.........@@.@@@@.@..........@....@......@..........@.................@.@@..@....@.....
.@.@...@....@........@..@@......@..@@.@@.....@.@.@.....@@@...@.@@....@@.......@........@.........@..@........@.@.....@......@...
.@.@.@.@@@......@..@@@@.....@.............@..@..@.........@.....@...@@@..@@...@.@.@@........@..@.@.....@.@..............@...@...
...@.@.....@@...@..@.@.......@.....@..@...@@...@@.....@.......@......@@@@.@....@@..@.@.@@.@..@...@......@....@..@.@..@.........@
....@...@....@..........@...@..@...@..@....@......@....@@.@..@.@....@@@.....@...@....@..@@......@.@@..@.....@@@....@...@.......@
...........@@..@@@@.......@@.......@.@..@@@.@..@.....@...@..@...@..@@@..@..@@..@@@....@@.......@..@...@@.....@....@.....@..@....
@...@@.@............@.@...@......@...@..........@.@.....@........................@..@......@..@..@...@................@.........
@.@..........@....@........@....@@@....@@...........@...@...@.......@........@............................@.....@........@@@...@
@.......@...@.@@@.@.....@....@@.@......@.@@........@...@..@@...@.@.....@.............@....@@....@...@..@......@.@.....@@@.......
.@...@..@...@....@@@.............@....@.....@...@.@@@..@@@......@..@...@..@....@........@.@......@..........@.....@...@.@.@.@@..
......@.@....@....@.@@.@@....@@.....@@.......@..@..@.@.@.@....@@@.@.......@.@@..@.@....@.....@..@@..@.......@@.@.....@...@...@@.
.@.......@.......@....@...........@@...@.@@.......@..@.....@........@..@.@.@..@..@...............@........@.@...@@............@@
.@.@.@..@.......@......@.@.@....@..@........@.@.@..@....@@@.............@@..........@.................@...@.@..@......@.@.@.....
.....@...@.@.........@@@@.......@...@............@.....@@@...@..@.....@.@@@@@.@....@@@@@@@....@@@..@.........@@...@@.....@..@.@.
...........@@@@@.............@..@...@.@.@@.....@...@..@..@.@.@..@..@....@@@@.@@@@...@@.@..@.....@...@...............@........@..
@..@....@..@....@.@@@.@.@....@....@@......@......@@.....@....@...@.@......@@..@@@.@....@.@..@.........@....@@....@...........@..
.....@@..@.@@....@..@.@....@.@.@..........@@..@..@..@@......@.........@.......@.......@...@.@@.@.....@@@........@.@@...@.@....@@
.@....@.....@........@...@......@@....@....@....@.@.@@....@@...@@.........@..@.@....@..@...@....@.@.@.@....@..@......@.@@....@@@
@@@@.@.....@@...@.........@...@.@...........@@@@..............@.......@..@@....@.@..@..@....@..@....@..........@.@.......@...@@@
@@@....@......@.@..@.@..@..@.@@..........@@@.......@...@@..@..@.@@..@...@@@@..@......@....@.......@.....@..@.........@.....@@@@@
@@.@..@.@@..@.....@@..@@.@.....@.@...@@@.@@@.....@...@@@.........@......@@...@....@.@......@...@.@@........@..@.@......@.@..@@@@
@....@....@...@@..@@@@.....@...@.....@@...........@.@.....@.@...@@..@........@..@@..@....@.@..@..........@@.@....@.@...@....@@..
@.....@...............@.@..@@@....@.....@@@.....@.........@..@..@..@@@..@..@......................@..............@.@@..@.@......